NO textures/sponge.xpm
SO textures/sponge.xpm
WE textures/sponge.xpm
EA textures/sponge.xpm

F 220,100,0
C 225,30,0

1111111111
1000000001
1000000001
1000P00001
1111111111
