NO textures/sponge.xpm
SO textures/sponge.xpm
WE textures/sponge.xpm
EA textures/sponge.xpm

F 220,100,0
C 225,30,0
  11111111
  11111111
  11000011
  11011111
  11N11
  11011 
  11011
  11111
  11111