NO textures/cobblestone.xpm
SO textures/sponge.xpm
WE textures/basalt.xpm
EA textures/soulsoil.xpm

F 230,169,20
C 153,204,255
11111111111111111111111111111111111111111111111111111111111
1N000000000000000000000000000000000000000000000000000000001
10000000000000000000000000000000000000000000000000000000001
10000000000000000000000000000000000000000000000000000000001
10000000000000000000000000000000000000000000000000000000001
10000000000000000000000000000000000000000000000000000000001
10000000000000000000000000000000000000000000000000000000001
10100000000000000000000000000000000000000000000000000000001
10000000000000000000000000000000000000000000000000000000001
10000000000000000000000000000000000000000000000000000000001
10010000000000000000000000000000000000000000000000000000001
10000000000000000000000000000000000000000000000000000000001
10000000000000000000000000000000000000000000000000000000001
10001000000000000000000000000000000000000000000000000000001
10000000000000000000000000000000000000000000000000000000001
10000000000000000000000000000000000000000000000000000000001
10000100000000000000000000000000000000000000000000000000001
10000000000000000000000000000000000000000000000000000000001
10000000000000000000000000000000000000000000000000000000001
10000010000000000000000000000000000000000000000000000000001
10000000000000000000000000000000000000000000000000000000001
10000000000000000000000000000000000000000000000000000000001
10000001000000000000000000000000000000000000000000000000001
10000000000000000000000000000000000000000000000000000000001
10000000000000000000000000000000000000000000000000000000001
10000000100000000000000000000000000000000000000000000000001
10000000000000000000000000000000000000000000000000000000001
10000000000000000000000000000000000000000000000000000000001
10000000010000000000000000000000000000000000000000000000001
10000000000000000000000000000000000000000000000000000000001
10000000000000000000000000000000000000000000000000000000001
10000000001000000000000000000000000000000000000000000000001
10000000000000000000000000000000000000000000000000000000001
10000000000000000000000000000000000000000000000000000000001
10000000000100000000000000000000000000000000000000000000001
10000000000000000000000000000000000000000000000000000000001
10000000000000000000000000000000000000000000000000000000001
10000000000010000000000000000000000000000000000000000000001
10000000000000000000000000000000000000000000000000000000001
10000000000000000000000000000000000000000000000000000000001
10000000000001000000000000000000000000000000000000000000001
10000000000000000000000000000000000000000000000000000000001
10000000000000000000000000000000000000000000000000000000001
10000000000000100000000000000000000000000000000000000000001
10000000000000000000000000000000000000000000000000000000001
10000000000000000000000000000000000000000000000000000000001
10000000000000010000000000000000000000000000000000000000001
10000000000000000000000000000000000000000000000000000000001
10000000000000000000000000000000000000000000000000000000001
10000000000000001000000000000000000000000000000000000000001
10000000000000000000000000000000000000000000000000000000001
10000000000000000000000000000000000000000000000000000000001
10111111111111111111111111111111111111111111111111111111111
100000101000100010001
101110101110101110111
101000100000100010101
101011111111111010101
100010000000000010001
101010111011111111101
101000001000000000001
101111111111111111111
101
101
101
101
101
101
101
101
101
101
101
101
101
101
101
101
101
101
101
101
101
101
101
101
101
101
101
101
101
101
101
101
101
101
101
101
101
101
101
101
101
101
101
101
101
101
101
101
101
101
101
101
101
101
101
101
101
101
101
101
101
101
101
101
101
101
101
101
101
101
101
101
101
101
101
101
101
101
101
101
101
101
101
101
101
101
101
101
101
101
101
101
101
101
101
101
101
101
101
101
101
101
101
101
101
101
101
101
101
101
101
101
101
101
101
101
101
101
101
101
101
101
101
101
101
101
101
101
101
101
101
101
101
101
101
101
101
101
101
101
101
101
101
101
101
101
101
101
101
101
101
101
101
101
101
101
101
101
101
101
101
101
101
101
101
101
101
101
101
101
101
101
101
101
101
101
101
101
101
101
101
101
101
101
101
101
101
101
101
101
101
101
101
101
101
101
101
101
101
101
101
101
101
101
101
101
101
101
101
101
101
101
101
101
101
101
101
101
101
101
101
101
101
101
101
101
101
101
101
101
101
101
101
101
101
101
101
101
101
101
101
101
101
101
101
101
101
101
101
101
101
101
101
101
101
101
101
101
101
101
101
101
101
101
101
101
101
101
101
101
101
101
101
101
101
101
101
101
101
101
101
101
101
101
101
101
101
101
101
101
101
101
101
101
101
101
101
101
101
101
101
101
101
101
101
101
101
101
101
101
101
101
101
101
101
101
101
101
101
101
101
101
101
101
101
101
101
101
101
101
101
101
101
101
101
101
101
101
101
101
101
101
101
101
101
101
101
101
101
101
101
101
101
101
101
101
101
101
101
101
101
101
101
101
101
101
101
101
101
101
101
101
101
101
101
101
101
101
101
101
101
101
101
101
101
101
101
101
101
101
101
101
101
101
101
101
101
101
101
101
101
101
101
101
101
101
101
101
101
101
101
101
101
101
101
101
101
101
101
101
111